year,firms,estabs,emp,denom,estabs_entry,estabs_entry_rate,estabs_exit,estabs_exit_rate,job_creation,job_creation_births,job_creation_continuers,job_creation_rate_births,job_creation_rate,job_destruction,job_destruction_deaths,job_destruction_continuers,job_destruction_rate_deaths,job_destruction_rate,net_job_creation,net_job_creation_rate,reallocation_rate,firmdeath_firms,firmdeath_estabs,firmdeath_emp
1978,3556792,4309087,69343368,66751651,653248,15.458,487051,11.525,14661850,5186329,9475521,7.770,21.965,9481403,4064364,5417039,6.089,14.204,5180447,7.761,28.408,327133,332430,1825561
1979,3669291,4448833,73334025,71221069,625171,14.340,446657,10.245,13877812,4846585,9031227,6.805,19.486,9647576,3628922,6018654,5.095,13.546,4230236,5.940,27.092,299501,304149,1674881
1980,3680090,4490716,73753303,73559310,581431,13.068,498221,11.198,12088588,4636595,7451993,6.303,16.434,11692752,3746094,7946658,5.093,15.896,395836,0.538,31.791,346328,352230,1918265
1981,3731587,4573076,74381166,73983265,576302,12.776,451584,10.011,11952898,4663739,7289159,6.304,16.156,11148852,3296935,7851917,4.456,15.069,804046,1.087,30.139,296080,302652,1546778
1982,3719903,4596342,74692330,74463460,598866,13.130,528277,11.582,12666062,5227062,7439000,7.020,17.010,12205806,3729605,8476201,5.009,16.392,460256,0.618,32.783,364758,371526,1921834
1983,3828456,4711790,73798206,73809337,623264,13.498,434670,9.414,12507223,4875288,7631935,6.605,16.945,12523836,3520283,9003553,4.769,16.968,-16613,-0.023,33.891,293386,300161,1740711
1984,3995645,4900675,78684102,76001425,697997,14.619,445548,9.332,15033247,5410576,9622671,7.119,19.780,9659920,3168837,6491083,4.169,12.710,5373327,7.070,25.420,319134,325241,1750690
1985,4069600,4986024,81629041,79738731,690958,14.091,526209,10.731,15382934,5747731,9635203,7.208,19.292,11611272,4344649,7266623,5.449,14.562,3771662,4.730,29.123,378194,386442,2423066
1986,4122471,5069302,83424543,82062357,693921,13.930,518027,10.399,15163651,5854634,9309017,7.134,18.478,12439080,4102172,8336908,4.999,15.158,2724571,3.320,30.316,366723,373967,2229917
1987,4186233,5172999,85343294,84477456,735080,14.461,555330,10.925,16339541,6644136,9695405,7.865,19.342,14607294,4899599,9707695,5.800,17.291,1732247,2.051,34.583,382838,390594,2490647
1988,4309957,5361852,88361935,86910598,745787,14.178,542630,10.316,16503488,6446218,10057270,7.417,18.989,13611143,4767647,8843496,5.486,15.661,2892345,3.328,31.322,380178,389540,2505930
1989,4384502,5477512,91425097,89635489,729028,13.538,543841,10.099,16460156,6156873,10303283,6.869,18.363,12903655,4526931,8376724,5.050,14.396,3556501,3.968,28.791,387018,398749,2499662
1990,4448864,5575023,93775686,92447509,704312,12.817,544967,9.917,15637207,5712846,9924361,6.180,16.915,12979327,4217126,8762201,4.562,14.040,2657880,2.875,28.079,396782,407908,2522475
1991,4416359,5609129,91546954,92394964,693553,12.482,588163,10.585,14139606,5764477,8375129,6.239,15.303,15849131,5097262,10751869,5.517,17.154,-1709525,-1.850,30.607,416808,429067,3132666
1992,4421175,5624107,91835255,91438284,655099,11.740,566552,10.154,14956131,5357813,9598318,5.859,16.357,14158321,4542360,9615961,4.968,15.484,797810,0.873,30.968,376513,386975,2439402
1993,4498560,5687666,93346013,92573476,657017,11.635,575585,10.193,15139718,5107717,10032001,5.517,16.354,13613998,4703662,8910336,5.081,14.706,1525720,1.648,29.412,377056,389300,2326379
1994,4581753,5800967,95863051,94739165,688672,11.993,570945,9.943,15508468,5594873,9913595,5.906,16.370,13255126,4735442,8519684,4.998,13.991,2253342,2.378,27.982,390650,402910,2613354
1995,4679786,5930378,99243906,97477536,710582,12.132,564375,9.635,16239364,5900570,10338794,6.053,16.660,12695852,4438037,8257815,4.553,13.024,3543512,3.635,26.049,389411,402769,2491890
1996,4727251,6003496,100010529,99206833,703152,11.824,589468,9.913,15763332,5796826,9966506,5.843,15.889,14166159,4873475,9292684,4.912,14.279,1597173,1.610,28.559,406173,419116,2606510
1997,4781344,6080240,103190328,101747252,740676,12.276,647650,10.734,18342577,6641549,11701028,6.527,18.028,15436380,5745590,9690790,5.647,15.171,2906197,2.856,30.343,422933,437998,2881271
1998,4856029,6183518,107541216,105929648,706729,11.524,604907,9.864,18154041,6344179,11809862,5.989,17.138,14901604,5271775,9629829,4.977,14.067,3252437,3.070,28.135,389103,402157,2461552
1999,4884135,6246924,109815409,108717792,694725,11.195,611957,9.861,17847077,6273462,11573615,5.770,16.416,15647018,5612235,10034783,5.162,14.392,2200059,2.024,28.785,396981,412784,2711867
2000,4904472,6294153,113244045,111610836,685677,10.950,621138,9.919,18881558,6430757,12450801,5.762,16.917,15618356,5821873,9796483,5.216,13.994,3263202,2.924,27.987,392418,408768,2557202
2001,4915673,6339105,114005181,113561918,699306,11.089,633249,10.042,17925138,6487625,11437513,5.713,15.784,17056762,5820825,11235937,5.126,15.020,868376,0.765,30.040,396002,411976,2693710
2002,4931648,6392739,111638272,113158035,758314,11.918,698630,10.980,18467153,7407868,11059285,6.546,16.320,21518265,7386892,14131373,6.528,19.016,-3051112,-2.696,32.640,421696,438851,3587986
2003,4992530,6458593,112324189,111938528,728119,11.346,645526,10.059,17607322,5945036,11662286,5.311,15.729,16841798,5642962,11198836,5.041,15.046,765524,0.684,30.091,399028,410695,2521584
2004,5078400,6558383,113967458,113174766,738411,11.356,626861,9.640,17146607,5740205,11406402,5.072,15.151,15598087,5403297,10194790,4.774,13.782,1548520,1.368,27.565,399410,411635,2527748
2005,5168067,6676914,115325937,114723894,775444,11.728,645302,9.760,16987719,6150185,10837534,5.361,14.807,15778849,5030641,10748208,4.385,13.754,1208870,1.054,27.508,418435,429686,2572336
2006,5257680,6839199,119104875,117243849,872425,12.927,691525,10.247,18827295,7040444,11786851,6.005,16.058,15125515,5121614,10003901,4.368,12.901,3701780,3.157,25.802,479161,489562,2788689
2007,5294414,6918586,119696081,119400209,801134,11.665,699750,10.189,18202566,6263049,11939517,5.245,15.245,17613386,5673974,11939412,4.752,14.752,589180,0.493,29.503,445303,455019,2666557
2008,5233440,6875208,119435399,119483760,704952,10.233,731911,10.625,16875066,5525101,11349965,4.624,14.123,17008042,5455519,11552523,4.566,14.235,-132976,-0.111,28.247,479355,489926,2733562
2009,5092637,6737952,113558316,116625656,628218,9.223,774478,11.371,13335117,4909849,8425268,4.210,11.434,19483796,5482029,14001767,4.701,16.706,-6148679,-5.272,22.868,494143,507052,2944481
2010,5019721,6670569,111189088,112354541,631913,9.437,683206,10.203,13339063,4682908,8656155,4.168,11.872,15648166,4558912,11089254,4.058,13.927,-2309103,-2.055,23.745,423578,436123,2312077
2011,4996729,6667493,112782486,111961277,655214,9.836,642407,9.644,14699420,4518780,10180640,4.036,13.129,13044541,4108166,8936375,3.669,11.651,1654879,1.478,23.302,405403,418345,2114443
2012,5043290,6710119,115180620,113948891,664644,9.950,603597,9.036,15662425,4623950,11038475,4.058,13.745,13192044,4296743,8895301,3.771,11.577,2470381,2.168,23.154,363440,375726,2111227
2013,5068514,6747790,117365364,116259096,657208,9.780,601073,8.945,15460525,4813137,10647388,4.140,13.298,13248669,4377583,8871086,3.765,11.396,2211856,1.903,22.792,371170,378869,2136461
2014,5106259,6825551,120000949,118634631,668341,9.858,576966,8.510,15535602,4997623,10537979,4.213,13.095,12798936,4017779,8781157,3.387,10.789,2736666,2.307,21.577,373760,382192,2062560
2015,5151953,6909513,123137424,121541504,681888,9.939,583893,8.511,16225649,5316721,10908928,4.374,13.350,13023484,4109989,8913495,3.382,10.715,3202165,2.635,21.431,376556,386335,2167639
2016,5219520,7037244,125656688,124365060,704200,10.107,564315,8.099,15985697,5194373,10791324,4.177,12.854,13408380,4173593,9234787,3.356,10.781,2577317,2.072,21.563,386147,396356,2277208
2017,5252110,7072108,127308658,126302765,673134,9.552,623388,8.846,16908284,5111061,11797223,4.047,13.387,14902144,4925128,9977016,3.899,11.799,2006140,1.588,23.597,407099,418490,2483530
2018,5285307,7097130,129840639,128567846,646859,9.145,598999,8.469,16336798,5018114,11318684,3.903,12.707,13783136,4309269,9473867,3.352,10.721,2553662,1.986,21.441,432643,448507,2509059
